##########
#S       #
#  ####  #
#  #  #  #
#  #  #  #
#  ##  G #
##########
